1111111111111
1C000000000C1
1110000000001
1P00010001001
10000100000E1
1111111111111