1111111111111
1C000000000C1
1110011111001
1P0001E001001
1000010000001
1111111111111